#########################S#########################
#         #           #       #     #     #     # #
######### # ##### ### # ####### # # # ### # # # # #
#     #   # #   # #   # #       # # # # #   # #   #
# # ### ##### # # # ### # ####### # # # ##### ### #
# #   #       #   #   #     #     # #       # # # #
##### ############### ####### ##### ### ##### # # #
#     #     #   #   #     #   #     # # #   # #   #
# ##### # # ### # # ##### # ##### ### # # # # #####
#     # # #   # # #   #   # #   #     # # #   #   #
# ### # # ### # # ### # ### # # ####### # ##### # #
# # #   # # #   #   #   #     #   #     #       # #
# # ##### # ### ### ############# # ############# #
#   # #   #     # #       #     # #       #       #
### # # ####### # ####### # ### # # ##### # ##### #
# # # # #     #   #     # # # # #   #   # # #     #
# # # # # ### ##### # ### # # # # ### # ### ### ###
# # # # #   # #   # # #   # #   #   # #   #   #   #
# # # # ### # # # # # # ### # ####### ### ### ### #
#     #     #   #   #       #         #       #   #
#########################E#########################